*XX*XX*X***X
****XX***XXX
XXX*XX*XXX*X
**X**X*XX**X
X***X**XX*XX
XXX***X***XX
XXXX*XX*XX*X
XX****X****X
XX*XX*XXXX**